WWWWWWWWWWWWWA
W*          WA
WB   BP     WA
W    *      WA
W         B*WA
WWWWWWWWWWWWWA     
             A
E