 WWWWWWWW    A 
 W      WWW  A
WWBWWW    WWWA
W P  B      WA
W    W  B   WA
W I**W   BWWWA
WW **W    W  A
 WWWWWWWWWW  A
E