WWWWWWWWWWWWA
W          WA
W  BIIIB   WA
W  P***B   WA
W          WA
WWWWWWWWWWWWA
E