WWWWWWWWWWWWWWWWWWWWWWWWWA
WW*WW*WW*WW*WW*WPWW*WWWWWA
WW WW WW WW WW W WW WWWWWA
WWBWWBWWBWWBWWBWBWWBWWWWWA
WW                     WWA
WW                     WWA
WW                     WWA
WW         *           WWA
WW                     WWA
WW                     WWA
WWWWWWWWWWWWWWWWWWWWWWWWWA
E