  WWWWW                    A
WWW  WWWWWWWWW             A
W            WWWWWWWWWW    A
W  BW                 WWWWWA
W  *W**IB             B  PWA
W  *W  B              WWWWWA
W            WWWWWWWWWW    A
WWWWWWWWWWWWWW             A
E