 WWWWWWWWW       A
WW*     *WWWWW   A
W  WWWWW     WWW A
W    B         WWA
W   B*B       BPWA
W    B         WWA
W        WWWWWWW A
W  WWWWW W       A
W*      *W       A
WWWWWWWWWW       A
E